.............................
.............................
.............................
.............................
.............................
.............................
.............................
.............................
.............................
...........................F.
........................11111
.P.....2.....................
111111111111111111...........
