...................
...................
...................
...................
...................
...................
...................
...................
...................
...................
...................
.P...............F.
1111111111....11111
