.............................
.............................
.............................
.............................
.............................
.............................
.............................
.............................
...........................F.
.....................11111111
.............................
.P.........2.................
1111111111111111.............
