...................
...................
...................
...................
...................
...................
...................
...................
...................
...................
...D...............
.P.....2.........F.
1111111111111111111