..............................
..............................
..............................
..............................
..............................
..............................
..............................
..............................
..............................
..............................
.P..........................F.
111111111111....1111....111111
