....................................................................................................................
....................................................................................................................
....................................................................................................................
....................................................................................................................
....................................................................................................................
....................................................................................................................
....................................................................................................................
....................................................................................................................
....................................................................................................................
....................................................................................................................
.P..................................................................................................................
11111111111111111111111111111111111111111111111111111111111111111111111111111111111111111111111111111111111111111111
